1/1/1/1/2/2/2/2/2/1/1/1/1/1/1/1/1/1/1/1/1/1
1/1/1/1/2/1/1/1/2/1/1/1/1/1/1/1/1/1/1/1/1/1
1/1/1/1/2/6/1/1/2/1/1/1/1/1/1/1/1/1/1/1/1/1
1/1/2/2/2/1/1/6/2/2/2/1/1/1/1/1/1/1/1/1/1/1
1/1/2/1/1/6/1/1/6/1/2/1/1/1/1/1/1/1/1/1/1/1
2/2/2/1/2/1/2/2/2/1/2/1/1/1/1/1/2/2/2/2/2/2
2/1/1/1/2/1/2/2/2/1/2/2/2/2/2/2/2/1/1/5/5/2
2/1/6/1/1/6/1/1/1/1/1/1/1/1/1/1/1/1/1/5/5/2
2/2/2/2/2/1/2/2/2/2/1/2/3/2/2/2/2/1/1/5/5/2
1/1/1/1/2/1/1/1/1/1/1/2/2/2/1/1/2/2/2/2/2/2
1/1/1/1/2/2/2/2/2/2/2/2/1/1/1/1/1/1/1/1/1/1