1/1/2/2/2/2/2/1
2/2/2/1/1/1/2/1
2/5/3/6/1/1/2/1
2/2/2/1/6/5/2/1
2/5/2/2/6/1/2/1
2/1/2/1/5/1/2/2
2/6/1/7/6/6/5/2
2/1/1/1/5/1/1/2
2/2/2/2/2/2/2/2